11111111111
1P000000001
10000000001
1000C000E01
10000000001
10000000001
11111111111
