11111111111
1P100010001
1C1C0C1C0C1
10101010101
1C0C1C0C1C1
100010001E1
11111111111
