11111111111
1P1C001C001
1C100C100C1
10100000101
100C100C101
1C0010001E1
11111111111
