11111111111111111111
1P000000C11C000000C1
10C11000011000011C01
1000C1100000011C0001
1C0000C110011C0000C1
11111C000CC000C11111
1C000000C11C000000C1
1000C1111111111C0001
10000000011000000001
1C000000C11C000000E1
11111111111111111111
